M-34-100-B-a-1-2-2
M-34-100-B-a-2-1-1
M-34-100-B-a-2-1-2
M-34-100-B-a-2-2-1
M-34-100-B-a-2-2-2
M-34-100-B-b-1-1-1
M-34-100-B-b-1-1-2
M-34-100-B-b-1-2-1
M-34-100-B-b-1-2-2
M-34-100-B-b-2-1-1
M-34-100-B-b-2-1-2
M-34-100-B-b-2-2-1
M-34-100-B-b-2-2-2
M-34-101-A-a-1-1-1
M-34-101-A-a-1-1-2
M-34-101-A-a-1-2-1
M-34-101-A-a-1-2-2
M-34-101-A-a-2-1-1
M-34-101-A-a-2-1-2
M-34-101-A-a-2-2-1
M-34-101-A-a-2-2-2
M-34-101-A-b-1-1-1
M-34-101-A-b-1-1-2
M-34-101-A-b-1-2-1
M-34-101-A-b-1-2-2
M-34-101-A-b-2-1-1
M-34-100-B-a-1-2-4
M-34-100-B-a-2-1-3
M-34-100-B-a-2-1-4
M-34-100-B-a-2-2-3
M-34-100-B-a-2-2-4
M-34-100-B-b-1-1-3
M-34-100-B-b-1-1-4
M-34-100-B-b-1-2-3
M-34-100-B-b-1-2-4
M-34-100-B-b-2-1-3
M-34-100-B-b-2-1-4
M-34-100-B-b-2-2-3
M-34-100-B-b-2-2-4
M-34-101-A-a-1-1-3
M-34-101-A-a-1-1-4
M-34-101-A-a-1-2-3
M-34-101-A-a-1-2-4
M-34-101-A-a-2-1-3
M-34-101-A-a-2-1-4
M-34-101-A-a-2-2-3
M-34-101-A-a-2-2-4
M-34-101-A-b-1-1-3
M-34-101-A-b-1-1-4
M-34-101-A-b-1-2-3
M-34-101-A-b-1-2-4
M-34-100-B-a-1-4-1
M-34-100-B-a-1-4-2
M-34-100-B-a-2-3-1
M-34-100-B-a-2-3-2
M-34-100-B-a-2-4-1
M-34-100-B-a-2-4-2
M-34-100-B-b-1-3-1
M-34-100-B-b-1-3-2
M-34-100-B-b-1-4-1
M-34-100-B-b-1-4-2
M-34-100-B-b-2-3-1
M-34-100-B-b-2-3-2
M-34-100-B-b-2-4-1
M-34-100-B-b-2-4-2
M-34-101-A-a-1-3-1
M-34-101-A-a-1-3-2
M-34-101-A-a-1-4-1
M-34-101-A-a-1-4-2
M-34-101-A-a-2-3-1
M-34-101-A-a-2-3-2
M-34-101-A-a-2-4-1
M-34-101-A-a-2-4-2
M-34-101-A-b-1-3-1
M-34-101-A-b-1-3-2
M-34-101-A-b-1-4-1
M-34-101-A-b-1-4-2
M-34-100-B-a-1-4-3
M-34-100-B-a-1-4-4
M-34-100-B-a-2-3-3
M-34-100-B-a-2-3-4
M-34-100-B-a-2-4-3
M-34-100-B-a-2-4-4
M-34-100-B-b-1-3-3
M-34-100-B-b-1-3-4
M-34-100-B-b-1-4-3
M-34-100-B-b-1-4-4
M-34-100-B-b-2-3-3
M-34-100-B-b-2-3-4
M-34-100-B-b-2-4-3
M-34-100-B-b-2-4-4
M-34-101-A-a-1-3-3
M-34-101-A-a-1-3-4
M-34-101-A-a-1-4-3
M-34-101-A-a-1-4-4
M-34-101-A-a-2-3-3
M-34-101-A-a-2-3-4
M-34-101-A-a-2-4-3
M-34-101-A-a-2-4-4
M-34-101-A-b-1-3-3
M-34-100-B-a-3-2-2
M-34-100-B-a-4-1-1
M-34-100-B-a-4-1-2
M-34-100-B-a-4-2-1
M-34-100-B-a-4-2-2
M-34-100-B-b-3-1-1
M-34-100-B-b-3-1-2
M-34-100-B-b-3-2-1
M-34-100-B-b-3-2-2
M-34-100-B-b-4-1-1
M-34-100-B-b-4-1-2
M-34-100-B-b-4-2-1
M-34-100-B-b-4-2-2
M-34-101-A-a-3-1-1
M-34-101-A-a-3-1-2
M-34-101-A-a-3-2-1
M-34-101-A-a-3-2-2
M-34-101-A-a-4-1-1
M-34-101-A-a-4-1-2
M-34-101-A-a-4-2-1
M-34-101-A-a-4-2-2
M-34-101-A-b-3-1-1
M-34-100-B-a-3-2-4
M-34-100-B-a-4-1-3
M-34-100-B-a-4-1-4
M-34-100-B-a-4-2-3
M-34-100-B-a-4-2-4
M-34-100-B-b-3-1-3
M-34-100-B-b-3-1-4
M-34-100-B-b-3-2-3
M-34-100-B-b-3-2-4
M-34-100-B-b-4-1-3
M-34-100-B-b-4-1-4
M-34-100-B-b-4-2-3
M-34-100-B-b-4-2-4
M-34-101-A-a-3-1-3
M-34-101-A-a-3-1-4
M-34-101-A-a-3-2-3
M-34-101-A-a-3-2-4
M-34-101-A-a-4-1-3
M-34-101-A-a-4-1-4
M-34-101-A-a-4-2-3
M-34-101-A-a-4-2-4
M-34-101-A-b-3-1-3
M-34-100-B-a-3-4-1
M-34-100-B-a-3-4-2
M-34-100-B-a-4-3-1
M-34-100-B-a-4-3-2
M-34-100-B-a-4-4-1
M-34-100-B-a-4-4-2
M-34-100-B-b-3-3-1
M-34-100-B-b-3-3-2
M-34-100-B-b-3-4-1
M-34-100-B-b-3-4-2
M-34-100-B-b-4-3-1
M-34-100-B-b-4-3-2
M-34-100-B-b-4-4-1
M-34-100-B-b-4-4-2
M-34-101-A-a-3-3-1
M-34-101-A-a-3-3-2
M-34-101-A-a-3-4-1
M-34-101-A-a-3-4-2
M-34-101-A-a-4-3-1
M-34-101-A-a-4-3-2
M-34-101-A-a-4-4-1
M-34-101-A-a-4-4-2
M-34-101-A-b-3-3-1
M-34-100-B-a-3-4-3
M-34-100-B-a-3-4-4
M-34-100-B-a-4-3-3
M-34-100-B-a-4-3-4
M-34-100-B-a-4-4-3
M-34-100-B-a-4-4-4
M-34-100-B-b-3-3-3
M-34-100-B-b-3-3-4
M-34-100-B-b-3-4-3
M-34-100-B-b-3-4-4
M-34-100-B-b-4-3-3
M-34-100-B-b-4-3-4
M-34-100-B-b-4-4-3
M-34-100-B-b-4-4-4
M-34-101-A-a-3-3-3
M-34-101-A-a-3-3-4
M-34-101-A-a-3-4-3
M-34-101-A-a-3-4-4
M-34-101-A-a-4-3-3
M-34-101-A-a-4-3-4
M-34-101-A-a-4-4-3
M-34-101-A-a-4-4-4
M-34-100-B-c-1-1-2
M-34-100-B-c-1-2-1
M-34-100-B-c-1-2-2
M-34-100-B-c-2-1-1
M-34-100-B-c-2-1-2
M-34-100-B-c-2-2-1
M-34-100-B-c-2-2-2
M-34-100-B-d-1-1-1
M-34-100-B-d-1-1-2
M-34-100-B-d-1-2-1
M-34-100-B-d-1-2-2
M-34-100-B-d-2-1-1
M-34-100-B-d-2-1-2
M-34-100-B-d-2-2-1
M-34-100-B-d-2-2-2
M-34-101-A-c-1-1-1
M-34-101-A-c-1-1-2
M-34-101-A-c-1-2-1
M-34-101-A-c-1-2-2
M-34-101-A-c-2-1-1
M-34-101-A-c-2-1-2
M-34-101-A-c-2-2-1
M-34-100-B-c-1-1-4
M-34-100-B-c-1-2-3
M-34-100-B-c-1-2-4
M-34-100-B-c-2-1-3
M-34-100-B-c-2-1-4
M-34-100-B-c-2-2-3
M-34-100-B-c-2-2-4
M-34-100-B-d-1-1-3
M-34-100-B-d-1-1-4
M-34-100-B-d-1-2-3
M-34-100-B-d-1-2-4
M-34-100-B-d-2-1-3
M-34-100-B-d-2-1-4
M-34-100-B-d-2-2-3
M-34-100-B-d-2-2-4
M-34-101-A-c-1-1-3
M-34-101-A-c-1-1-4
M-34-101-A-c-1-2-3
M-34-101-A-c-1-2-4
M-34-101-A-c-2-1-3
M-34-101-A-c-2-1-4
M-34-101-A-c-2-2-3
M-34-100-B-c-1-3-1
M-34-100-B-c-1-3-2
M-34-100-B-c-1-4-1
M-34-100-B-c-1-4-2
M-34-100-B-c-2-3-1
M-34-100-B-c-2-3-2
M-34-100-B-c-2-4-1
M-34-100-B-c-2-4-2
M-34-100-B-d-1-3-1
M-34-100-B-d-1-3-2
M-34-100-B-d-2-4-2
M-34-101-A-c-1-3-1
M-34-101-A-c-1-3-2
M-34-101-A-c-1-4-1
M-34-101-A-c-1-4-2
M-34-101-A-c-2-3-1
M-34-101-A-c-2-3-2
M-34-101-A-c-2-4-1
M-34-100-B-c-1-3-3
M-34-100-B-c-1-3-4
M-34-100-B-c-1-4-3
M-34-100-B-c-1-4-4
M-34-100-B-c-2-3-3
M-34-100-B-c-2-3-4
M-34-100-B-c-2-4-3
M-34-100-B-c-2-4-4
M-34-100-B-d-1-3-3
M-34-100-B-d-1-3-4
M-34-101-A-c-1-3-3
M-34-101-A-c-1-3-4
M-34-101-A-c-1-4-3
M-34-101-A-c-1-4-4
M-34-101-A-c-2-3-3
M-34-101-A-c-2-3-4
M-34-101-A-c-2-4-3
M-34-100-B-c-3-1-1
M-34-100-B-c-3-1-2
M-34-100-B-c-3-2-1
M-34-100-B-c-3-2-2
M-34-100-B-c-4-1-1
M-34-100-B-c-4-1-2
M-34-100-B-c-4-2-1
M-34-100-B-c-4-2-2
M-34-100-B-d-3-1-1
M-34-101-A-c-3-1-1
M-34-101-A-c-3-1-2
M-34-101-A-c-3-2-1
M-34-101-A-c-3-2-2
M-34-101-A-c-4-1-1
M-34-101-A-c-4-1-2
M-34-100-B-c-4-1-4
M-34-100-B-c-4-2-3
M-34-100-B-c-4-2-4
M-34-101-A-c-3-2-3
M-34-101-A-c-3-2-4
M-34-101-A-c-4-1-3
M-34-101-A-c-4-1-4
M-34-101-A-c-4-3-1
M-34-101-A-c-4-3-2