000111111111111111111111111110
000111111111111111111111111100
001111111111111111111111111100
001111111111111111111111100000
000111111111111111111111100000
000111111111111111111111100000
001111111111111111111111100000
001111111111111111111111000000
011111111111111111111110000000
011111111111111111111110000000
111111111100000111111110000000
111111111100000011111110000000
111111111000000011111100000000
000001110000000000111100000000
000000000000000000001100000000
000000000000000000000000000000